name,Id,Intelligence,Strength,Speed,Durability,Power,Combat,Overall_ps
"Martian Manhunter",432,100,95,92,100,100,85,572
Supergirl,643,94,100,100,100,100,75,569
"Power Girl",524,94,100,100,100,100,75,569
"Wonder Woman",720,88,100,79,100,100,100,567
Phoenix,517,100,100,83,100,100,80,563
Spectre,613,88,100,100,100,100,70,558
Thor,659,69,100,83,100,100,100,552
"Captain Marvel",156,88,100,88,95,100,75,546
Nova,496,100,85,75,100,100,80,540
Hulk,332,88,100,63,100,98,85,534
