name,Id,Intelligence,Strength,Speed,Durability,Power,Combat,Overall_ps
Superboy-Prime,642,94,100,100,100,100,85,579
Darkseid,204,88,100,83,100,100,95,566
Amazo,20,63,100,83,100,100,100,546
Faora,253,88,95,75,100,98,90,546
"Cyborg Superman",195,75,93,92,100,100,80,540
Doomsday,230,75,100,67,100,100,90,532
"Cheetah III",174,88,100,88,80,78,95,529
Apocalypse,35,100,100,33,100,100,60,493
Abraxas,5,88,63,83,100,100,55,489
Brainiac,136,100,95,63,90,60,75,483
